"";"D. execució";"D. valor";"Concepte";"Import";"Saldo"
"";"06/12/2021";"06/12/2021";"COMPRA TARJETA DEBITO/CREDITO PROXIMA TJ*5783";"-6,09";"2.748,14"
"";"06/12/2021";"06/12/2021";"RECIBO ANA MARIA POVEDA NAVARRO";"-200,00";"2.754,23"
"";"04/12/2021";"04/12/2021";"COMPRA TARJETA DEBITO/CREDITO BEAUTY BY DIA IGUALADA 60 TJ*0011";"-1,38";"2.954,23"
"";"04/12/2021";"04/12/2021";"COMPRA TARJETA DEBITO/CREDITO CAL FONT TJ*0011";"-12,20";"2.955,61"
"";"04/12/2021";"04/12/2021";"COMPRA TARJETA DEBITO/CREDITO SUPERMERCADOS SUPER MAS TJ*0011";"-142,97";"2.967,81"
"";"04/12/2021";"04/12/2021";"COMPRA TARJETA DEBITO/CREDITO ESCLATOIL PIERA TJ*0011";"-50,00";"3.110,78"
"";"03/12/2021";"03/12/2021";"COMPRA TARJETA DEBITO/CREDITO BEAUTY BY DIA IGUALADA 60 TJ*0011";"-6,60";"3.160,78"
"";"03/12/2021";"03/12/2021";"COMPRA TARJETA DEBITO/CREDITO ABACUS IGUALADA TJ*0011";"-4,10";"3.167,38"
"";"03/12/2021";"03/12/2021";"COMPRA TARJETA DEBITO/CREDITO PIERA TJ*0011";"-9,54";"3.171,48"
"";"03/12/2021";"03/12/2021";"RECIBO PIJUAN";"-38,00";"3.181,02"
"";"01/12/2021";"01/12/2021";"COMPRA TARJETA DEBITO/CREDITO S.I.M.A. TJ*0011";"-0,35";"3.219,02"
"";"01/12/2021";"01/12/2021";"COMPRA TARJETA DEBITO/CREDITO S.I.M.A. TJ*0011";"-0,60";"3.219,37"
"";"01/12/2021";"01/12/2021";"COMPRA TARJETA DEBITO/CREDITO LO NECESITO SL TJ*0011";"-14,50";"3.219,97"
"";"01/12/2021";"01/12/2021";"TRANSFERENCIA IGRID S.L. ABONO NOMINA 11/2021";"1.811,26";"3.234,47"
"";"30/11/2021";"30/11/2021";"COMPRA TARJETA DEBITO/CREDITO S.I.M.A. TJ*0011";"-0,35";"1.423,21"
"";"30/11/2021";"30/11/2021";"COMPRA TARJETA DEBITO/CREDITO S.I.M.A. TJ*0011";"-0,35";"1.423,56"
"";"30/11/2021";"30/11/2021";"COMPRA TARJETA DEBITO/CREDITO S.I.M.A. TJ*0011";"-0,70";"1.423,91"
"";"30/11/2021";"30/11/2021";"COMPRA TARJETA DEBITO/CREDITO S.I.M.A. TJ*0011";"-0,35";"1.424,61"
"";"30/11/2021";"30/11/2021";"COMPRA TARJETA DEBITO/CREDITO S.I.M.A. TJ*0011";"-0,35";"1.424,96"
"";"30/11/2021";"30/11/2021";"COMPRA TARJETA DEBITO/CREDITO HIPERMERCAT ESCLAT H23P TJ*0011";"-12,31";"1.425,31"
"";"26/11/2021";"26/11/2021";"RECIBO MINYONS ESCOLTES GUIES SANT JORDI DE CAT";"-160,00";"1.437,62"
"";"25/11/2021";"25/11/2021";"COMPRA TARJETA DEBITO/CREDITO GUISSONA T533 TJ*0011";"-17,25";"1.597,62"
"";"23/11/2021";"23/11/2021";"COMPRA TARJETA DEBITO/CREDITO S.I.M.A. TJ*0011";"-0,50";"1.614,87"
"";"23/11/2021";"23/11/2021";"TRANSF PARA Astrid Formacio Marta Pardos i Mas";"-75,00";"1.615,37"
"";"22/11/2021";"22/11/2021";"COMPRA TARJETA DEBITO/CREDITO PIERA TJ*0011";"-16,75";"1.690,37"
"";"20/11/2021";"20/11/2021";"COMPRA TARJETA DEBITO/CREDITO ELS FOGONS DE L ANOIA TJ*0011";"-10,50";"1.707,12"
"";"20/11/2021";"20/11/2021";"RENOVACION PLAZO";"-3.000,00";"1.717,62"
"";"20/11/2021";"20/11/2021";"CANCELACION PLAZO";"3.000,00";"4.717,62"
"";"20/11/2021";"20/11/2021";"LIQUIDACION PLAZO";"1,21";"1.717,62"
"";"19/11/2021";"19/11/2021";"COMPRA TARJETA DEBITO/CREDITO FARMACIA RIGOL TJ*0011";"-28,91";"1.716,41"
"";"19/11/2021";"19/11/2021";"COMPRA TARJETA DEBITO/CREDITO S.I.M.A. TJ*0011";"-0,45";"1.745,32"
"";"19/11/2021";"19/11/2021";"COMPRA TARJETA DEBITO/CREDITO S.I.M.A. TJ*0011";"-0,80";"1.745,77"
"";"19/11/2021";"19/11/2021";"COMPRA TARJETA DEBITO/CREDITO SUPERMERCADOS SUPER MAS TJ*0011";"-77,49";"1.746,57"
"";"19/11/2021";"19/11/2021";"COMPRA TARJETA DEBITO/CREDITO PINTURES PLANELL TJ*0011";"-49,90";"1.824,06"
"";"18/11/2021";"18/11/2021";"COMPRA TARJETA DEBITO/CREDITO FARMACIA RIGOL TJ*0011";"-35,10";"1.873,96"
"";"17/11/2021";"17/11/2021";"COMPRA TARJETA DEBITO/CREDITO FARMACIA RIGOL TJ*0011";"-93,66";"1.909,06"
"";"16/11/2021";"16/11/2021";"COMPRA TARJETA DEBITO/CREDITO S.I.M.A. TJ*0011";"-1,25";"2.002,72"
"";"16/11/2021";"16/11/2021";"COMPRA TARJETA DEBITO/CREDITO ESCLATOIL PIERA TJ*0011";"-50,00";"2.003,97"
"";"15/11/2021";"15/11/2021";"COMPRA TARJETA DEBITO/CREDITO LA PANERA DEL PA IGUALADA TJ*0011";"-13,04";"2.053,97"
"";"15/11/2021";"15/11/2021";"COMPRA TARJETA DEBITO/CREDITO TRES UNCES TJ*0011";"-11,19";"2.067,01"
"";"15/11/2021";"15/11/2021";"COMPRA TARJETA DEBITO/CREDITO S.I.M.A. TJ*0011";"-0,35";"2.078,20"
"";"15/11/2021";"15/11/2021";"RECIBO SIMYO";"-12,55";"2.078,55"
"";"15/11/2021";"15/11/2021";"RECIBO SIMYO";"-13,50";"2.091,10"
"";"13/11/2021";"13/11/2021";"COMPRA TARJETA DEBITO/CREDITO CASA AMETLLER SL TJ*0011";"-21,31";"2.104,60"
"";"13/11/2021";"13/11/2021";"COMPRA TARJETA DEBITO/CREDITO HIPER ASIATICO 2012 S.L. TJ*0011";"-7,86";"2.125,91"
"";"12/11/2021";"12/11/2021";"COMPRA TARJETA DEBITO/CREDITO HIPERMERCAT ESCLAT H23P TJ*0011";"-15,50";"2.133,77"
"";"12/11/2021";"12/11/2021";"COMPRA TARJETA DEBITO/CREDITO FARMACIA RIGOL TJ*0011";"-17,26";"2.149,27"
"";"10/11/2021";"10/11/2021";"COMPRA TARJETA DEBITO/CREDITO PIERA TJ*0011";"-28,94";"2.166,53"
"";"10/11/2021";"10/11/2021";"COMPRA TARJETA DEBITO/CREDITO FARMACIA RIGOL TJ*0011";"-52,90";"2.195,47"
"";"09/11/2021";"09/11/2021";"COMPRA TARJETA DEBITO/CREDITO SIMYO TJ*5783";"-7,00";"2.248,37"
"";"09/11/2021";"09/11/2021";"COMPRA TARJETA DEBITO/CREDITO S.I.M.A. TJ*0011";"-1,00";"2.255,37"
"";"09/11/2021";"09/11/2021";"COMPRA TARJETA DEBITO/CREDITO LA PANERA DEL PA IGUALADA TJ*0011";"-6,35";"2.256,37"
"";"08/11/2021";"08/11/2021";"COMPRA TARJETA DEBITO/CREDITO GUISSONA T533 TJ*0011";"-32,82";"2.262,72"
"";"08/11/2021";"08/11/2021";"COMPRA TARJETA DEBITO/CREDITO ESCLATOIL PIERA TJ*0011";"-50,00";"2.295,54"
"";"07/11/2021";"07/11/2021";"COMPRA TARJETA DEBITO/CREDITO PASTISSERIA FIDEL SERRA S TJ*5783";"-5,10";"2.345,54"
"";"06/11/2021";"06/11/2021";"COMPRA TARJETA DEBITO/CREDITO ROGES SUPERMERCATS TJ*0011";"-5,23";"2.350,64"
"";"06/11/2021";"06/11/2021";"COMPRA TARJETA DEBITO/CREDITO BEAUTY BY DIA IGUALADA 60 TJ*0011";"-10,73";"2.355,87"
"";"06/11/2021";"06/11/2021";"COMPRA TARJETA DEBITO/CREDITO S.I.M.A. TJ*0011";"-0,35";"2.366,60"
"";"06/11/2021";"06/11/2021";"COMPRA TARJETA DEBITO/CREDITO FARMACIA RIGOL TJ*0011";"-4,72";"2.366,95"
"";"05/11/2021";"05/11/2021";"COMPRA TARJETA DEBITO/CREDITO CONDIS LIFE -CAPELLADES TJ*0011";"-37,92";"2.371,67"
"";"05/11/2021";"05/11/2021";"RECIBO IGUANA COMUNICACIONS S.L.";"-33,90";"2.409,59"
"";"05/11/2021";"05/11/2021";"RECIBO ORANGE ESPAGNE S.A.";"-29,95";"2.443,49"
"";"05/11/2021";"05/11/2021";"RECIBO COL.LEGI OFICIAL DE FARMACEUTICS DE BCN";"-37,23";"2.473,44"
"";"05/11/2021";"05/11/2021";"RECIBO ANA MARIA POVEDA NAVARRO";"-175,00";"2.510,67"
"";"04/11/2021";"04/11/2021";"COMPRA TARJETA DEBITO/CREDITO FARMACIA RIGOL TJ*0011";"-6,20";"2.685,67"
"";"02/11/2021";"02/11/2021";"COMPRA TARJETA DEBITO/CREDITO S.I.M.A. TJ*0011";"-1,30";"2.691,87"
"";"02/11/2021";"02/11/2021";"RECIBO PIJUAN";"-38,00";"2.693,17"
"";"02/11/2021";"02/11/2021";"TRANSFERENCIA IGRID S.L. ABONO NOMINA 10/2021";"1.811,26";"2.731,17"
"";"30/10/2021";"30/10/2021";"COMPRA TARJETA DEBITO/CREDITO CASA AMETLLER SL TJ*0011";"-16,96";"919,91"
"";"30/10/2021";"30/10/2021";"COMPRA TARJETA DEBITO/CREDITO CALZEDONIA IGUALADA TJ*0011";"-10,00";"936,87"
"";"30/10/2021";"30/10/2021";"COMPRA TARJETA DEBITO/CREDITO MARKET IGUALAD2 TJ*0011";"-18,71";"946,87"
"";"30/10/2021";"30/10/2021";"COMPRA TARJETA DEBITO/CREDITO GUISSONA T533 TJ*0011";"-21,37";"965,58"
"";"30/10/2021";"30/10/2021";"COMPRA TARJETA DEBITO/CREDITO PIERA TJ*0011";"-25,48";"986,95"
"";"29/10/2021";"29/10/2021";"COMPRA TARJETA DEBITO/CREDITO FARMACIA RIGOL TJ*0011";"-5,42";"1.012,43"
"";"29/10/2021";"29/10/2021";"COMPRA TARJETA DEBITO/CREDITO FARMACIA RIGOL TJ*0011";"-4,77";"1.017,85"
"";"29/10/2021";"29/10/2021";"COMPRA TARJETA DEBITO/CREDITO HIPER ASIATICO 2012 S.L. TJ*0011";"-25,48";"1.022,62"
"";"29/10/2021";"29/10/2021";"COMPRA TARJETA DEBITO/CREDITO CAP I CUA TJ*0011";"-8,75";"1.048,10"
"";"29/10/2021";"29/10/2021";"COMPRA TARJETA DEBITO/CREDITO LA PANERA DEL PA IGUALADA TJ*0011";"-18,10";"1.056,85"
"";"29/10/2021";"29/10/2021";"COMPRA TARJETA DEBITO/CREDITO EMBOTITS MARIA ASSUMPCIO TJ*0011";"-55,16";"1.074,95"
"";"29/10/2021";"29/10/2021";"RECIBO PayPal (Europe) S.a.r.l. et Cie., S.C.A.";"-20,89";"1.130,11"
"";"27/10/2021";"27/10/2021";"TRANSF DE DANIEL ORTINEZ MARTI dinar aniversari";"82,50";"1.151,00"
"";"26/10/2021";"26/10/2021";"COMPRA TARJETA DEBITO/CREDITO S.I.M.A. TJ*0011";"-0,35";"1.068,50"
"";"26/10/2021";"26/10/2021";"COMPRA TARJETA DEBITO/CREDITO S.I.M.A. TJ*0011";"-0,75";"1.068,85"
"";"26/10/2021";"26/10/2021";"COMPRA TARJETA DEBITO/CREDITO HIPERMERCAT ESCLAT H23P TJ*0011";"-38,19";"1.069,60"
"";"25/10/2021";"23/10/2021";"COMPRA TARJETA DEBITO/CREDITO MUNICH - CAPELLADES TJ*0011";"-30,00";"1.107,79"
"";"23/10/2021";"23/10/2021";"COMPRA TARJETA DEBITO/CREDITO LA LIONESA TJ*5783";"-9,40";"1.137,79"
"";"22/10/2021";"22/10/2021";"COMPRA TARJETA DEBITO/CREDITO S.I.M.A. TJ*0011";"-0,70";"1.147,19"
"";"22/10/2021";"22/10/2021";"COMPRA TARJETA DEBITO/CREDITO S.I.M.A. TJ*0011";"-0,70";"1.147,89"
"";"21/10/2021";"21/10/2021";"COMPRA TARJETA DEBITO/CREDITO PIERA TJ*0011";"-18,17";"1.148,59"
"";"20/10/2021";"20/10/2021";"COMPRA TARJETA DEBITO/CREDITO E.S.SERVI ODENA S.L. TJ*0011";"-20,00";"1.166,76"
"";"19/10/2021";"19/10/2021";"COMPRA TARJETA DEBITO/CREDITO S.I.M.A. TJ*0011";"-0,35";"1.186,76"
"";"19/10/2021";"19/10/2021";"COMPRA TARJETA DEBITO/CREDITO HIPERMERCAT ESCLAT H23P TJ*0011";"-36,18";"1.187,11"
"";"19/10/2021";"19/10/2021";"COMPRA TARJETA DEBITO/CREDITO FARMACIA RIGOL TJ*0011";"-106,15";"1.223,29"
"";"18/10/2021";"18/10/2021";"COMPRA TARJETA DEBITO/CREDITO SUPERMERCADOS SUPER MAS TJ*0011";"-100,20";"1.329,44"
"";"14/10/2021";"14/10/2021";"RECIBO SIMYO";"-12,00";"1.429,64"
"";"14/10/2021";"14/10/2021";"RECIBO SIMYO";"-10,00";"1.441,64"
"";"11/10/2021";"11/10/2021";"COMPRA TARJETA DEBITO/CREDITO RESTAURANT LA BARBACANA TJ*0011";"-52,30";"1.451,64"
"";"11/10/2021";"11/10/2021";"COMPRA TARJETA DEBITO/CREDITO S.I.M.A. TJ*0011";"-0,35";"1.503,94"
"";"09/10/2021";"09/10/2021";"COMPRA TARJETA DEBITO/CREDITO KIDDY S CLASS TJ*5783";"-28,90";"1.504,29"
"";"09/10/2021";"09/10/2021";"COMPRA TARJETA DEBITO/CREDITO LUMBERTON TJ*0011";"-39,90";"1.533,19"
"";"09/10/2021";"09/10/2021";"COMPRA TARJETA DEBITO/CREDITO CRONOTIME TJ*5783";"-28,00";"1.573,09"
"";"08/10/2021";"08/10/2021";"COMPRA TARJETA DEBITO/CREDITO FARMACIA RIGOL TJ*0011";"-28,85";"1.601,09"
"";"08/10/2021";"08/10/2021";"RECIBO ORANGE ESPAGNE S.A.";"-19,67";"1.629,94"
"";"08/10/2021";"08/10/2021";"RECIBO PayPal (Europe) S.a.r.l. et Cie., S.C.A.";"-2,33";"1.649,61"
"";"08/10/2021";"08/10/2021";"RECIBO COL.LEGI OFICIAL DE FARMACEUTICS DE BCN";"-37,23";"1.651,94"
"";"08/10/2021";"08/10/2021";"RECIBO ANA MARIA POVEDA NAVARRO";"-150,00";"1.689,17"
"";"07/10/2021";"07/10/2021";"COMPRA TARJETA DEBITO/CREDITO HIPERMERCAT ESCLAT H23P TJ*0011";"-31,01";"1.839,17"
"";"06/10/2021";"06/10/2021";"RECIBO IGUANA COMUNICACIONS S.L.";"-33,90";"1.870,18"
"";"04/10/2021";"04/10/2021";"TRANSFERENCIA IGRID S.L. ABONO NOMINA 09/2021";"1.448,99";"1.904,08"
"";"02/10/2021";"02/10/2021";"COMPRA TARJETA DEBITO/CREDITO MES MERCAT SL TJ*0011";"-17,77";"455,09"
"";"02/10/2021";"02/10/2021";"COMPRA TARJETA DEBITO/CREDITO HIPER JUNBO TJ*0011";"-24,95";"472,86"
"";"01/10/2021";"01/10/2021";"COMPRA TARJETA DEBITO/CREDITO FARMACIA RIGOL TJ*0011";"-38,00";"497,81"
"";"01/10/2021";"01/10/2021";"COMPRA TARJETA DEBITO/CREDITO S.I.M.A. TJ*0011";"-0,35";"535,81"
"";"01/10/2021";"01/10/2021";"TRANSF DE Consell Comarcal de l Anoia AJUTS REALITZACIO ACTIVITATS ART";"105,00";"536,16"
"";"30/09/2021";"30/09/2021";"LIQUIDACION AHORRO/CTA COR";"0,00";"431,16"
"";"29/09/2021";"29/09/2021";"COMPRA TARJETA DEBITO/CREDITO HIPER JUNBO TJ*0011";"-8,48";"431,16"
"";"28/09/2021";"28/09/2021";"COMPRA TARJETA DEBITO/CREDITO MES MERCAT SL TJ*0011";"-21,58";"439,64"
"";"28/09/2021";"28/09/2021";"COMPRA TARJETA DEBITO/CREDITO DRIM IGUALADA FARO TJ*0011";"-25,00";"461,22"
"";"28/09/2021";"28/09/2021";"COMPRA TARJETA DEBITO/CREDITO S.I.M.A. TJ*0011";"-0,35";"486,22"
"";"27/09/2021";"27/09/2021";"COMPRA TARJETA DEBITO/CREDITO 9 ABA CICLES TJ*5783";"-33,96";"486,57"
"";"25/09/2021";"25/09/2021";"COMPRA TARJETA DEBITO/CREDITO MES MERCAT SL TJ*0011";"-8,26";"520,53"
"";"24/09/2021";"24/09/2021";"COMPRA TARJETA DEBITO/CREDITO FARMACIA RIGOL TJ*0011";"-15,11";"528,79"
"";"24/09/2021";"24/09/2021";"COMPRA TARJETA DEBITO/CREDITO FARMACIA RIGOL TJ*0011";"-95,63";"543,90"
"";"24/09/2021";"24/09/2021";"COMPRA TARJETA DEBITO/CREDITO FARMACIA RIGOL TJ*0011";"-5,89";"639,53"
"";"23/09/2021";"23/09/2021";"COMPRA TARJETA DEBITO/CREDITO PEIXETERIA VILA MASSANA TJ*0011";"-11,14";"645,42"
"";"23/09/2021";"23/09/2021";"COMPRA TARJETA DEBITO/CREDITO S.I.M.A. TJ*0011";"-0,70";"656,56"
"";"23/09/2021";"23/09/2021";"COMPRA TARJETA DEBITO/CREDITO S.I.M.A. TJ*0011";"-1,00";"657,26"
"";"22/09/2021";"22/09/2021";"COMPRA TARJETA DEBITO/CREDITO PIERA TJ*0011";"-22,82";"658,26"
"";"21/09/2021";"21/09/2021";"COMPRA TARJETA DEBITO/CREDITO S.I.M.A. TJ*0011";"-0,35";"681,08"
"";"21/09/2021";"21/09/2021";"COMPRA TARJETA DEBITO/CREDITO LA BONA ESPARDENYA TJ*0011";"-21,50";"681,43"
"";"21/09/2021";"21/09/2021";"COMPRA TARJETA DEBITO/CREDITO S.I.M.A. TJ*0011";"-2,12";"702,93"
"";"19/09/2021";"19/09/2021";"COMPRA TARJETA DEBITO/CREDITO GPV RODA DE BARA TJ*0011";"-9,22";"705,05"
"";"17/09/2021";"17/09/2021";"COMPRA TARJETA DEBITO/CREDITO S.I.M.A. TJ*0011";"-0,35";"714,27"
"";"17/09/2021";"17/09/2021";"COMPRA TARJETA DEBITO/CREDITO SUPERMERCADOS SUPER MAS TJ*0011";"-54,26";"714,62"
"";"17/09/2021";"17/09/2021";"COMPRA TARJETA DEBITO/CREDITO S.I.M.A. TJ*0011";"-1,45";"768,88"
"";"14/09/2021";"14/09/2021";"RECIBO SIMYO";"-12,00";"770,33"
"";"14/09/2021";"14/09/2021";"RECIBO SIMYO";"-10,00";"782,33"
"";"13/09/2021";"13/09/2021";"COMPRA TARJETA DEBITO/CREDITO BUREAU ANOIA SL TJ*0011";"-7,15";"792,33"
"";"13/09/2021";"13/09/2021";"COMPRA TARJETA DEBITO/CREDITO PIERA TJ*0011";"-17,90";"799,48"
"";"10/09/2021";"10/09/2021";"COMPRA TARJETA DEBITO/CREDITO BOTIGA BUFF TJ*0011";"-17,47";"817,38"
"";"10/09/2021";"10/09/2021";"COMPRA TARJETA DEBITO/CREDITO SUPERMERCADOS SUPER MAS TJ*0011";"-65,06";"834,85"
"";"10/09/2021";"10/09/2021";"RECIBO COL.LEGI OFICIAL DE FARMACEUTICS DE BCN";"-37,23";"899,91"
"";"10/09/2021";"10/09/2021";"COMPRA TARJETA DEBITO/CREDITO ESCLATOIL PIERA TJ*0011";"-50,00";"937,14"
"";"09/09/2021";"09/09/2021";"COMPRA TARJETA DEBITO/CREDITO FARMACIA RIGOL TJ*0011";"-37,50";"987,14"
"";"09/09/2021";"09/09/2021";"COMPRA TARJETA DEBITO/CREDITO FARMACIA RIGOL TJ*0011";"-11,70";"1.024,64"
"";"08/09/2021";"08/09/2021";"COMPRA TARJETA DEBITO/CREDITO MES MERCAT SL TJ*0011";"-20,23";"1.036,34"
"";"07/09/2021";"07/09/2021";"RECIBO ORANGE ESPAGNE S.A.";"-10,78";"1.056,57"
"";"06/09/2021";"06/09/2021";"COMPRA TARJETA DEBITO/CREDITO S.I.M.A. TJ*0011";"-1,50";"1.067,35"
"";"06/09/2021";"06/09/2021";"RECIBO IGUANA COMUNICACIONS S.L.";"-33,90";"1.068,85"
"";"03/09/2021";"03/09/2021";"COMPRA TARJETA DEBITO/CREDITO CASA AMETLLER SL TJ*0011";"-19,58";"1.102,75"
"";"03/09/2021";"03/09/2021";"COMPRA TARJETA DEBITO/CREDITO CONDIS LIFE -CAPELLADES TJ*5783";"-47,58";"1.122,33"
"";"03/09/2021";"03/09/2021";"RECIBO MINYONS ESCOLTES GUIES SANT JORDI DE CAT";"-80,00";"1.169,91"
"";"02/09/2021";"02/09/2021";"COMPRA TARJETA DEBITO/CREDITO FULL EQUIP SPORTS SCP TJ*5783";"-28,00";"1.249,91"
"";"02/09/2021";"02/09/2021";"COMPRA TARJETA DEBITO/CREDITO CAL FONT TJ*0011";"-18,94";"1.277,91"
"";"02/09/2021";"02/09/2021";"COMPRA TARJETA DEBITO/CREDITO S.I.M.A. TJ*0011";"-0,35";"1.296,85"
"";"02/09/2021";"02/09/2021";"COMPRA TARJETA DEBITO/CREDITO PIERA TJ*0011";"-11,43";"1.297,20"
"";"01/09/2021";"01/09/2021";"COMPRA TARJETA DEBITO/CREDITO S.I.M.A. TJ*0011";"-1,00";"1.308,63"
"";"01/09/2021";"01/09/2021";"TRANSF PARA MARTI I MARTA btt ....";"-500,00";"1.309,63"
"";"01/09/2021";"01/09/2021";"TRANSF DE FM UNLIMITED MOTORCYCLES,S.L. Nomina agosto + finiquito Mart";"1.739,99";"1.809,63"
"";"30/08/2021";"30/08/2021";"COMPRA TARJETA DEBITO/CREDITO PIERA TJ*0011";"-20,74";"69,64"
"";"28/08/2021";"28/08/2021";"COMPRA TARJETA DEBITO/CREDITO GELATS I TORRONS DONAT TJ*5783";"-12,40";"90,38"
"";"28/08/2021";"28/08/2021";"COMPRA TARJETA DEBITO/CREDITO TORRES MASIP TJ*0011";"-12,05";"102,78"
"";"28/08/2021";"28/08/2021";"COMPRA TARJETA DEBITO/CREDITO ALDI IGUALADA TJ*0011";"-59,99";"114,83"
"";"28/08/2021";"28/08/2021";"COMPRA TARJETA DEBITO/CREDITO PINTURES RALLI TJ*0011";"-17,35";"174,82"
"";"27/08/2021";"27/08/2021";"COMPRA TARJETA DEBITO/CREDITO FRANKFURT CLEIN TJ*0011";"-30,30";"192,17"
"";"27/08/2021";"27/08/2021";"COMPRA TARJETA DEBITO/CREDITO PIERA TJ*0011";"-20,99";"222,47"
"";"26/08/2021";"26/08/2021";"COMPRA TARJETA DEBITO/CREDITO HIPERMERCAT ESCLAT H78I TJ*0011";"-15,60";"243,46"
"";"25/08/2021";"25/08/2021";"COMPRA TARJETA DEBITO/CREDITO SUMO CATALAN SCP TJ*0011";"-32,49";"259,06"
"";"25/08/2021";"25/08/2021";"COMPRA TARJETA DEBITO/CREDITO FARMACIA RIGOL TJ*0011";"-23,60";"291,55"
"";"25/08/2021";"25/08/2021";"COMPRA TARJETA DEBITO/CREDITO FARMACIA RIGOL TJ*0011";"-33,00";"315,15"
"";"25/08/2021";"25/08/2021";"COMISION TARJETA";"-12,00";"348,15"
"";"24/08/2021";"24/08/2021";"COMPRA TARJETA DEBITO/CREDITO TALLERS PIERA SCP TJ*0011";"-1.118,77";"360,15"
"";"24/08/2021";"24/08/2021";"TRANSF DE MARTI SOLER CHIVA COTXE";"1.000,00";"1.478,92"
"";"20/08/2021";"20/08/2021";"COMPRA TARJETA DEBITO/CREDITO BOHIGAS POP UP BAR TJ*0011";"-42,00";"478,92"
"";"20/08/2021";"20/08/2021";"COMPRA TARJETA DEBITO/CREDITO SUPERMERCADOS SUPER MAS TJ*5783";"-8,59";"520,92"
"";"20/08/2021";"20/08/2021";"COMPRA TARJETA DEBITO/CREDITO CAL FONT TJ*5783";"-13,06";"529,51"
"";"17/08/2021";"17/08/2021";"COMPRA TARJETA DEBITO/CREDITO MES MERCAT SL TJ*0011";"-18,35";"542,57"
"";"17/08/2021";"17/08/2021";"COMPRA TARJETA DEBITO/CREDITO PIERA TJ*0011";"-12,56";"560,92"
"";"15/08/2021";"15/08/2021";"COMPRA TARJETA DEBITO/CREDITO AUTOSERVEIS CA LA PILAR TJ*0011";"-19,47";"573,48"
"";"15/08/2021";"15/08/2021";"COMPRA TARJETA DEBITO/CREDITO PAISATGISME CAMARO TJ*0011";"-36,10";"592,95"
"";"14/08/2021";"14/08/2021";"COMPRA TARJETA DEBITO/CREDITO RIBA TJ*5783";"-23,72";"629,05"
"";"13/08/2021";"13/08/2021";"RECIBO SIMYO";"-10,00";"652,77"
"";"13/08/2021";"13/08/2021";"RECIBO SIMYO";"-12,01";"662,77"
"";"13/08/2021";"13/08/2021";"TRANSF DE MARTA PARDOS MAS TRASPAS";"600,00";"674,78"
"";"12/08/2021";"12/08/2021";"COMPRA TARJETA DEBITO/CREDITO FARMACIA RIGOL TJ*0011";"-37,00";"74,78"
"";"12/08/2021";"12/08/2021";"COMPRA TARJETA DEBITO/CREDITO ESCLATOIL PIERA TJ*0011";"-50,00";"111,78"
"";"11/08/2021";"11/08/2021";"COMPRA TARJETA DEBITO/CREDITO MES MERCAT SL TJ*0011";"-20,81";"161,78"
"";"11/08/2021";"11/08/2021";"COMPRA TARJETA DEBITO/CREDITO FARMACIA RIGOL TJ*0011";"-19,12";"182,59"
"";"10/08/2021";"10/08/2021";"COMPRA TARJETA DEBITO/CREDITO BEAUTY BY DIA IGUALADA 60 TJ*0011";"-6,39";"201,71"
"";"10/08/2021";"10/08/2021";"COMPRA TARJETA DEBITO/CREDITO SUPERMERCADOS SUPER MAS TJ*0011";"-76,93";"208,10"
"";"10/08/2021";"10/08/2021";"COMPRA TARJETA DEBITO/CREDITO ORANGE SIEBEL TJ*5783";"-8,25";"285,03"
"";"10/08/2021";"10/08/2021";"RECIBO PayPal (Europe) S.a.r.l. et Cie., S.C.A.";"-105,17";"293,28"
"";"10/08/2021";"10/08/2021";"RECIBO PayPal (Europe) S.a.r.l. et Cie., S.C.A.";"-31,15";"398,45"
"";"09/08/2021";"05/08/2021";"COMPRA TARJETA DEBITO/CREDITO DNH*GODADDY.COM EUROPE TJ*5783";"-20,14";"429,60"
"";"09/08/2021";"09/08/2021";"RECIBO ANA MARIA POVEDA NAVARRO";"-100,00";"449,74"
"";"07/08/2021";"07/08/2021";"COMPRA TARJETA DEBITO/CREDITO ESCLATOIL PIERA TJ*0011";"-50,00";"549,74"
"";"06/08/2021";"06/08/2021";"RECIBO ORANGE ESPAGNE S.A.";"-3,63";"599,74"
"";"05/08/2021";"05/08/2021";"RECIBO COL.LEGI OFICIAL DE FARMACEUTICS DE BCN";"-37,23";"603,37"
"";"05/08/2021";"05/08/2021";"RECIBO IGUANA COMUNICACIONS S.L.";"-33,90";"640,60"
"";"04/08/2021";"04/08/2021";"COMPRA TARJETA DEBITO/CREDITO MCDONALD S IGUALADA TJ*5783";"-28,50";"674,50"
"";"03/08/2021";"04/08/2021";"TRANSF PARA MARTA PARDOS MAS traspas agost";"-700,00";"703,00"
"";"03/08/2021";"03/08/2021";"COMPRA TARJETA DEBITO/CREDITO SUPERMERCADOS SUPER MAS TJ*0011";"-73,37";"1.403,00"
"";"03/08/2021";"03/08/2021";"COMPRA TARJETA DEBITO/CREDITO TRES UNCES TJ*0011";"-7,48";"1.476,37"
"";"02/08/2021";"02/08/2021";"COMPRA TARJETA DEBITO/CREDITO CAL FONT TJ*0011";"-8,30";"1.483,85"
"";"02/08/2021";"02/08/2021";"COMPRA TARJETA DEBITO/CREDITO BEAUTY BY DIA IGUALADA 60 TJ*0011";"-22,20";"1.492,15"
"";"31/07/2021";"31/07/2021";"COMPRA TARJETA DEBITO/CREDITO IKEA L HOSPITALET TJ*0011";"-0,75";"1.514,35"
"";"31/07/2021";"31/07/2021";"COMPRA TARJETA DEBITO/CREDITO IKEA L HOSPITALET TJ*0011";"-104,00";"1.515,10"
"";"31/07/2021";"31/07/2021";"COMPRA TARJETA DEBITO/CREDITO REST. IKEA HOSPITAL TJ*0011";"-9,95";"1.619,10"
"";"31/07/2021";"31/07/2021";"COMPRA TARJETA DEBITO/CREDITO HIPERMERCAT ESCLAT H23P TJ*0011";"-4,64";"1.629,05"
"";"31/07/2021";"31/07/2021";"COMPRA TARJETA DEBITO/CREDITO HIPERMERCAT ESCLAT H23P TJ*0011";"-6,13";"1.633,69"
"";"30/07/2021";"30/07/2021";"COMPRA TARJETA DEBITO/CREDITO DRIM IGUALADA TJ*0011";"-35,98";"1.639,82"
"";"30/07/2021";"30/07/2021";"COMPRA TARJETA DEBITO/CREDITO S.I.M.A. TJ*0011";"-0,45";"1.675,80"
"";"30/07/2021";"30/07/2021";"COMPRA TARJETA DEBITO/CREDITO FARMACIA RIGOL TJ*0011";"-13,40";"1.676,25"
"";"30/07/2021";"30/07/2021";"TRANSF DE FM UNLIMITED MOTORCYCLES,S.L. Nomina Julio Marti Soler Chiva";"1.450,00";"1.689,65"
"";"28/07/2021";"28/07/2021";"COMPRA TARJETA DEBITO/CREDITO VNG APARCAMENTS TJ*0011";"-5,20";"239,65"
"";"28/07/2021";"28/07/2021";"COMPRA TARJETA DEBITO/CREDITO ESCLATOIL PIERA TJ*0011";"-50,00";"244,85"
"";"28/07/2021";"28/07/2021";"COMPRA TARJETA DEBITO/CREDITO FARMACIA RIGOL TJ*0011";"-18,20";"294,85"
"";"27/07/2021";"27/07/2021";"COMPRA TARJETA DEBITO/CREDITO S.I.M.A. TJ*0011";"-0,35";"313,05"
"";"27/07/2021";"27/07/2021";"COMPRA TARJETA DEBITO/CREDITO S.I.M.A. TJ*0011";"-0,35";"313,40"
"";"27/07/2021";"27/07/2021";"COMPRA TARJETA DEBITO/CREDITO S.I.M.A. TJ*0011";"-0,65";"313,75"
"";"27/07/2021";"27/07/2021";"COMPRA TARJETA DEBITO/CREDITO HIPERMERCAT ESCLAT H23P TJ*0011";"-17,58";"314,40"
"";"24/07/2021";"24/07/2021";"COMPRA TARJETA DEBITO/CREDITO 9 ABA CICLES TJ*5783";"-44,50";"331,98"
"";"23/07/2021";"23/07/2021";"COMPRA TARJETA DEBITO/CREDITO PIERA TJ*0011";"-22,41";"376,48"
"";"23/07/2021";"23/07/2021";"COMPRA TARJETA DEBITO/CREDITO FARMACIA RIGOL TJ*0011";"-19,75";"398,89"
"";"22/07/2021";"22/07/2021";"COMPRA TARJETA DEBITO/CREDITO S.I.M.A. TJ*0011";"-0,40";"418,64"
"";"22/07/2021";"22/07/2021";"COMPRA TARJETA DEBITO/CREDITO S.I.M.A. TJ*0011";"-1,30";"419,04"
"";"21/07/2021";"21/07/2021";"COMPRA TARJETA DEBITO/CREDITO CONSUM IGUALADA TJ*0011";"-6,02";"420,34"
"";"20/07/2021";"20/07/2021";"COMPRA TARJETA DEBITO/CREDITO S.I.M.A. TJ*0011";"-0,65";"426,36"
"";"20/07/2021";"20/07/2021";"COMPRA TARJETA DEBITO/CREDITO S.I.M.A. TJ*0011";"-0,35";"427,01"
"";"20/07/2021";"20/07/2021";"COMPRA TARJETA DEBITO/CREDITO CRISTALLERIA MARIA 55SL U TJ*0011";"-44,50";"427,36"
"";"20/07/2021";"20/07/2021";"COMPRA TARJETA DEBITO/CREDITO S.I.M.A. TJ*0011";"-0,45";"471,86"
"";"20/07/2021";"20/07/2021";"COMPRA TARJETA DEBITO/CREDITO S.I.M.A. TJ*0011";"-0,35";"472,31"
"";"20/07/2021";"20/07/2021";"COMPRA TARJETA DEBITO/CREDITO HIPERMERCAT ESCLAT H23P TJ*0011";"-59,79";"472,66"
"";"20/07/2021";"20/07/2021";"IMPUESTO MOD.303 JUST.3032884812465";"-618,55";"532,45"
"";"19/07/2021";"19/07/2021";"COMPRA TARJETA DEBITO/CREDITO EDITORIAL LUIS VIVES TJ*5783";"-36,26";"1.151,00"
"";"19/07/2021";"19/07/2021";"COMPRA TARJETA DEBITO/CREDITO S.I.M.A. TJ*0011";"-1,10";"1.187,26"
"";"17/07/2021";"19/07/2021";"TRANSF PARA MARTA PARDOS MAS marta traspas";"-200,00";"1.188,36"
"";"17/07/2021";"17/07/2021";"COMPRA TARJETA DEBITO/CREDITO SUPERMERCADOS SUPER MAS TJ*0011";"-75,98";"1.388,36"
"";"17/07/2021";"17/07/2021";"COMPRA TARJETA DEBITO/CREDITO 94D SP IGUALADA TJ*0011";"-25,97";"1.464,34"
"";"17/07/2021";"17/07/2021";"COMPRA TARJETA DEBITO/CREDITO CENTRE OPTIC ANOIA TJ*5783";"-370,00";"1.490,31"
"";"16/07/2021";"16/07/2021";"COMPRA TARJETA DEBITO/CREDITO S.I.M.A. TJ*0011";"-0,35";"1.860,31"
"";"16/07/2021";"16/07/2021";"RECIBO SIMYO";"-12,00";"1.860,66"
"";"15/07/2021";"15/07/2021";"COMPRA TARJETA DEBITO/CREDITO S.I.M.A. TJ*0011";"-1,00";"1.872,66"
"";"15/07/2021";"15/07/2021";"RECIBO SIMYO";"-10,00";"1.873,66"
"";"14/07/2021";"14/07/2021";"COMPRA TARJETA DEBITO/CREDITO AMBIT DESCANS TJ*0011";"-449,00";"1.883,66"
"";"13/07/2021";"13/07/2021";"COMPRA TARJETA DEBITO/CREDITO S.I.M.A. TJ*0011";"-0,35";"2.332,66"
"";"13/07/2021";"13/07/2021";"COMPRA TARJETA DEBITO/CREDITO S.I.M.A. TJ*0011";"-1,20";"2.333,01"
"";"12/07/2021";"12/07/2021";"COMPRA TARJETA DEBITO/CREDITO S.I.M.A. TJ*0011";"-1,00";"2.334,21"
"";"12/07/2021";"08/07/2021";"COMPRA TARJETA DEBITO/CREDITO E.S. LA MARGINEDA TJ*5783";"-48,00";"2.335,21"
"";"12/07/2021";"08/07/2021";"COMPRA TARJETA DEBITO/CREDITO HIPER ANDORRA 2 TJ*0011";"-36,31";"2.383,21"
"";"12/07/2021";"02/07/2021";"COMPRA TARJETA DEBITO/CREDITO PKZOPALS TJ*0011";"-2,15";"2.419,52"
"";"11/07/2021";"11/07/2021";"COMPRA TARJETA DEBITO/CREDITO CASA AMETLLER TJ*0011";"-11,04";"2.421,67"
"";"11/07/2021";"11/07/2021";"COMPRA TARJETA DEBITO/CREDITO LA LIONESA TJ*0011";"-20,00";"2.432,71"
"";"10/07/2021";"10/07/2021";"COMPRA TARJETA DEBITO/CREDITO HIPER JUNBO TJ*0011";"-12,38";"2.452,71"
"";"09/07/2021";"09/07/2021";"RECIBO COL.LEGI OFICIAL DE FARMACEUTICS DE BCN";"-37,23";"2.465,09"
"";"09/07/2021";"09/07/2021";"COMPRA TARJETA DEBITO/CREDITO SUPERMERCADOS SUPER MAS TJ*0011";"-61,67";"2.502,32"
"";"09/07/2021";"09/07/2021";"COMPRA TARJETA DEBITO/CREDITO BUREAU ANOIA SL TJ*0011";"-7,30";"2.563,99"
"";"09/07/2021";"09/07/2021";"COMPRA TARJETA DEBITO/CREDITO ABACUS IGUALADA TJ*0011";"-6,60";"2.571,29"
"";"09/07/2021";"09/07/2021";"COMPRA TARJETA DEBITO/CREDITO S.I.M.A. TJ*0011";"-0,35";"2.577,89"
"";"09/07/2021";"07/07/2021";"COMPRA TARJETA DEBITO/CREDITO SUPERMERCATS PROXI 2 TJ*5783";"-12,90";"2.578,24"
"";"09/07/2021";"07/07/2021";"COMPRA TARJETA DEBITO/CREDITO SUPERMERCATS PROXI 2 TJ*5783";"-9,61";"2.591,14"
"";"08/07/2021";"08/07/2021";"COMPRA TARJETA DEBITO/CREDITO AREAS DE BASELLA S.L. TJ*0011";"-36,35";"2.600,75"
"";"08/07/2021";"06/07/2021";"COMPRA TARJETA DEBITO/CREDITO COMMENCAL SPOT TJ*0011";"-85,20";"2.637,10"
"";"08/07/2021";"06/07/2021";"COMPRA TARJETA DEBITO/CREDITO SUPERMERCATS PROXI 2 TJ*0011";"-12,61";"2.722,30"
"";"08/07/2021";"08/07/2021";"RECIBO ORANGE ESPAGNE S.A.";"-3,63";"2.734,91"
"";"06/07/2021";"06/07/2021";"RECIBO IGUANA COMUNICACIONS S.L.";"-33,90";"2.738,54"
"";"05/07/2021";"05/07/2021";"COMPRA TARJETA DEBITO/CREDITO FARMACIA MT GRANERO TJ*0011";"-12,37";"2.772,44"
"";"05/07/2021";"05/07/2021";"COMPRA TARJETA DEBITO/CREDITO CONDIS LIFE -CAPELLADES TJ*0011";"-49,12";"2.784,81"
"";"05/07/2021";"29/06/2021";"COMPRA TARJETA DEBITO/CREDITO A.C.E.S.A LA ROCA-LLORET TJ*5783";"-4,90";"2.833,93"
"";"04/07/2021";"04/07/2021";"COMPRA TARJETA DEBITO/CREDITO GELATS ENXANETA TJ*0011";"-13,80";"2.838,83"
"";"04/07/2021";"04/07/2021";"COMPRA TARJETA DEBITO/CREDITO F.B.LA CAIXA-J.CAP ROIG TJ*0011";"-20,00";"2.852,63"
"";"04/07/2021";"04/07/2021";"COMPRA TARJETA DEBITO/CREDITO SUPER BEGUR TJ*0011";"-12,98";"2.872,63"
"";"03/07/2021";"03/07/2021";"COMPRA TARJETA DEBITO/CREDITO SUPER BEGUR TJ*0011";"-6,85";"2.885,61"
"";"03/07/2021";"03/07/2021";"COMPRA TARJETA DEBITO/CREDITO CARNISSERIA ARNALL TJ*0011";"-4,76";"2.892,46"
"";"02/07/2021";"02/07/2021";"COMPRA TARJETA DEBITO/CREDITO SUPER BEGUR TJ*0011";"-17,91";"2.897,22"
"";"02/07/2021";"02/07/2021";"COMPRA TARJETA DEBITO/CREDITO CAN PADRES 1 TJ*0011";"-18,40";"2.915,13"
"";"02/07/2021";"02/07/2021";"COMPRA TARJETA DEBITO/CREDITO CH 16 COMPLEMENTS NAUTICS TJ*0011";"-42,99";"2.933,53"
"";"01/07/2021";"01/07/2021";"COMPRA TARJETA DEBITO/CREDITO SUPER BEGUR TJ*0011";"-9,51";"2.976,52"
"";"01/07/2021";"01/07/2021";"COMPRA TARJETA DEBITO/CREDITO CARNISSERIA ARNALL TJ*0011";"-3,19";"2.986,03"
"";"01/07/2021";"01/07/2021";"COMPRA TARJETA DEBITO/CREDITO CASA SOLE TJ*0011";"-9,95";"2.989,22"
"";"01/07/2021";"01/07/2021";"COMPRA TARJETA DEBITO/CREDITO SUPER BEGUR TJ*0011";"-15,68";"2.999,17"
"";"30/06/2021";"30/06/2021";"COMPRA TARJETA DEBITO/CREDITO SUPER BEGUR TJ*0011";"-12,72";"3.014,85"
"";"30/06/2021";"30/06/2021";"COMPRA TARJETA DEBITO/CREDITO CARNISSERIA ARNALL TJ*0011";"-18,20";"3.027,57"
"";"30/06/2021";"30/06/2021";"COMPRA TARJETA DEBITO/CREDITO HIBISCUS TOWN TJ*5783";"-6,05";"3.045,77"
"";"30/06/2021";"30/06/2021";"LIQUIDACION AHORRO/CTA COR";"0,00";"3.051,82"
"";"30/06/2021";"30/06/2021";"TRANSF DE FM UNLIMITED MOTORCYCLES,S.L. Nomina Junio Marti Soler Chiva";"1.450,00";"3.051,82"
"";"29/06/2021";"29/06/2021";"COMPRA TARJETA DEBITO/CREDITO BAR-RESTAURANT CA LA ADEL TJ*5783";"-8,80";"1.601,82"
"";"29/06/2021";"29/06/2021";"COMPRA TARJETA DEBITO/CREDITO SUPER BEGUR TJ*0011";"-13,47";"1.610,62"
"";"29/06/2021";"29/06/2021";"COMPRA TARJETA DEBITO/CREDITO CARNISSERIA ARNALL TJ*0011";"-21,91";"1.624,09"
"";"29/06/2021";"29/06/2021";"RECIBO MINYONS ESCOLTES GUIES SANT JORDI DE CAT";"-140,00";"1.646,00"
"";"28/06/2021";"28/06/2021";"COMPRA TARJETA DEBITO/CREDITO XINA CENTER DOS TJ*0011";"-8,67";"1.786,00"
"";"28/06/2021";"28/06/2021";"COMPRA TARJETA DEBITO/CREDITO SUPER BEGUR TJ*0011";"-4,00";"1.794,67"
"";"27/06/2021";"27/06/2021";"COMPRA TARJETA DEBITO/CREDITO SUPER BEGUR TJ*0011";"-59,22";"1.798,67"
"";"27/06/2021";"27/06/2021";"COMPRA TARJETA DEBITO/CREDITO CAMPING BEGUR TJ*0011";"-440,50";"1.857,89"
"";"27/06/2021";"27/06/2021";"COMPRA TARJETA DEBITO/CREDITO DECATHLON PLATJA D ARO TJ*0011";"-51,97";"2.298,39"
"";"26/06/2021";"26/06/2021";"COMPRA TARJETA DEBITO/CREDITO SUPERMERCADOS SUPER MAS TJ*5783";"-25,31";"2.350,36"
"";"25/06/2021";"25/06/2021";"COMPRA TARJETA DEBITO/CREDITO FARMACIA RIGOL TJ*0011";"-52,90";"2.375,67"
"";"22/06/2021";"22/06/2021";"COMPRA TARJETA DEBITO/CREDITO SUPERMERCADOS SUPER MAS TJ*0011";"-32,89";"2.428,57"
"";"22/06/2021";"22/06/2021";"COMPRA TARJETA DEBITO/CREDITO SUPERMERCADOS SUPER MAS TJ*0011";"-17,52";"2.461,46"
"";"22/06/2021";"22/06/2021";"COMPRA TARJETA DEBITO/CREDITO S.I.M.A. TJ*0011";"-1,05";"2.478,98"
"";"22/06/2021";"22/06/2021";"COMPRA TARJETA DEBITO/CREDITO HIPERMERCAT ESCLAT H23P TJ*0011";"-31,93";"2.480,03"
"";"22/06/2021";"20/06/2021";"COMPRA TARJETA DEBITO/CREDITO DNH*GODADDY.COM EUROPE TJ*5783";"-20,14";"2.511,96"
"";"22/06/2021";"22/06/2021";"TRANSF DE A.E.A.T. DEVOLUCIONES TRIBUTARIAS AEAT            APL:DECLAR";"513,84";"2.532,10"
"";"21/06/2021";"21/06/2021";"COMPRA TARJETA DEBITO/CREDITO FERRETERIA JORBA SOLA TJ*5783";"-15,31";"2.018,26"
"";"21/06/2021";"21/06/2021";"RECIBO PayPal (Europe) S.a.r.l. et Cie., S.C.A.";"-30,35";"2.033,57"
"";"20/06/2021";"21/06/2021";"TRANSF PARA MARTA PARDOS MAS traspas metes equivocades";"-400,00";"2.063,92"
"";"20/06/2021";"08/06/2021";"DEVOLUCION RECIBO ORANGE ESPAGNE S.A.";"9,17";"2.463,92"
"";"19/06/2021";"19/06/2021";"COMPRA TARJETA DEBITO/CREDITO ANTIGUA CASA MANUEL ESTAL TJ*0011";"-15,75";"2.454,75"
"";"19/06/2021";"19/06/2021";"COMPRA TARJETA DEBITO/CREDITO S.I.M.A. TJ*0011";"-2,00";"2.470,50"
"";"18/06/2021";"18/06/2021";"COMPRA TARJETA DEBITO/CREDITO SUPERMERCADOS SUPER MAS TJ*0011";"-29,57";"2.472,50"
"";"18/06/2021";"18/06/2021";"COMPRA TARJETA DEBITO/CREDITO JENINA FERRUS BELLES TJ*0011";"-13,00";"2.502,07"
"";"17/06/2021";"17/06/2021";"COMPRA TARJETA DEBITO/CREDITO FARMACIA RIGOL TJ*0011";"-22,68";"2.515,07"
"";"16/06/2021";"16/06/2021";"COMPRA TARJETA DEBITO/CREDITO PIERA TJ*0011";"-14,63";"2.537,75"
"";"15/06/2021";"15/06/2021";"COMPRA TARJETA DEBITO/CREDITO S.I.M.A. TJ*0011";"-0,35";"2.552,38"
"";"15/06/2021";"15/06/2021";"COMPRA TARJETA DEBITO/CREDITO STRADIVARIUS TJ*0011";"-32,98";"2.552,73"
"";"15/06/2021";"15/06/2021";"COMPRA TARJETA DEBITO/CREDITO S.I.M.A. TJ*0011";"-0,70";"2.585,71"
"";"15/06/2021";"15/06/2021";"COMPRA TARJETA DEBITO/CREDITO S.I.M.A. TJ*0011";"-0,85";"2.586,41"
"";"15/06/2021";"15/06/2021";"RECIBO PayPal (Europe) S.a.r.l. et Cie., S.C.A.";"-35,45";"2.587,26"
"";"14/06/2021";"14/06/2021";"COMPRA TARJETA DEBITO/CREDITO POLIGON TJ*5783";"-13,95";"2.622,71"
"";"14/06/2021";"14/06/2021";"COMPRA TARJETA DEBITO/CREDITO AMBIT DESCANS TJ*5783";"-500,00";"2.636,66"
"";"14/06/2021";"14/06/2021";"COMPRA TARJETA DEBITO/CREDITO PIERA TJ*0011";"-3,99";"3.136,66"
"";"14/06/2021";"14/06/2021";"RECIBO SIMYO";"-12,00";"3.140,65"
"";"14/06/2021";"14/06/2021";"RECIBO SIMYO";"-10,00";"3.152,65"
"";"12/06/2021";"12/06/2021";"COMPRA TARJETA DEBITO/CREDITO CASA AMETLLER SL TJ*0011";"-36,00";"3.162,65"
"";"12/06/2021";"12/06/2021";"COMPRA TARJETA DEBITO/CREDITO RECORD SPORTS TJ*0011";"-18,90";"3.198,65"
"";"11/06/2021";"11/06/2021";"COMPRA TARJETA DEBITO/CREDITO ABACUS IGUALADA TJ*0011";"-6,95";"3.217,55"
"";"11/06/2021";"11/06/2021";"COMPRA TARJETA DEBITO/CREDITO MARKET IGUALAD2 TJ*0011";"-36,61";"3.224,50"
"";"10/06/2021";"10/06/2021";"COMPRA TARJETA DEBITO/CREDITO MCDONALD S IGUALADA TJ*0011";"-37,50";"3.261,11"
"";"10/06/2021";"10/06/2021";"COMPRA TARJETA DEBITO/CREDITO S.I.M.A. TJ*0011";"-0,35";"3.298,61"
"";"10/06/2021";"10/06/2021";"COMPRA TARJETA DEBITO/CREDITO FARMACIA RIGOL TJ*0011";"-58,94";"3.298,96"
"";"10/06/2021";"10/06/2021";"COMPRA TARJETA DEBITO/CREDITO FARMACIA RIGOL TJ*0011";"-95,99";"3.357,90"
"";"09/06/2021";"09/06/2021";"COMPRA TARJETA DEBITO/CREDITO S.I.M.A. TJ*0011";"-1,85";"3.453,89"
"";"09/06/2021";"09/06/2021";"COMPRA TARJETA DEBITO/CREDITO PIERA TJ*0011";"-7,96";"3.455,74"
"";"08/06/2021";"08/06/2021";"COMPRA TARJETA DEBITO/CREDITO S.I.M.A. TJ*0011";"-0,35";"3.463,70"
"";"08/06/2021";"08/06/2021";"COMPRA TARJETA DEBITO/CREDITO S.I.M.A. TJ*0011";"-0,35";"3.464,05"
"";"08/06/2021";"08/06/2021";"COMPRA TARJETA DEBITO/CREDITO GLOBAL SALUT 2017 SCP TJ*0011";"-45,00";"3.464,40"
"";"08/06/2021";"08/06/2021";"COMPRA TARJETA DEBITO/CREDITO PIERA TJ*0011";"-8,69";"3.509,40"
"";"08/06/2021";"08/06/2021";"RECIBO ORANGE ESPAGNE S.A.";"-9,17";"3.518,09"
"";"07/06/2021";"07/06/2021";"COMPRA TARJETA DEBITO/CREDITO PIERA TJ*0011";"-18,42";"3.527,26"
"";"07/06/2021";"07/06/2021";"RECIBO COL.LEGI OFICIAL DE FARMACEUTICS DE BCN";"-37,23";"3.545,68"
"";"07/06/2021";"07/06/2021";"RECIBO IGUANA COMUNICACIONS S.L.";"-33,95";"3.582,91"
"";"05/06/2021";"05/06/2021";"COMPRA TARJETA DEBITO/CREDITO CASA AMETLLER SL TJ*0011";"-24,24";"3.616,86"
"";"05/06/2021";"05/06/2021";"COMPRA TARJETA DEBITO/CREDITO CAL RABEL TJ*0011";"-11,45";"3.641,10"
"";"05/06/2021";"05/06/2021";"COMPRA TARJETA DEBITO/CREDITO BEAUTY BY DIA IGUALADA 60 TJ*0011";"-14,37";"3.652,55"
"";"05/06/2021";"05/06/2021";"COMPRA TARJETA DEBITO/CREDITO ESCLATOIL PIERA TJ*0011";"-20,00";"3.666,92"
"";"01/06/2021";"01/06/2021";"COMPRA TARJETA DEBITO/CREDITO S.I.M.A. TJ*0011";"-1,10";"3.686,92"
"";"01/06/2021";"01/06/2021";"COMPRA TARJETA DEBITO/CREDITO VITALIS TJ*0011";"-130,00";"3.688,02"
"";"01/06/2021";"01/06/2021";"COMPRA TARJETA DEBITO/CREDITO FARMACIA RIGOL TJ*0011";"-8,77";"3.818,02"
"";"01/06/2021";"01/06/2021";"TRANSF DE Consell Comarcal de l Anoia 40. A COMPTE  - AJUTS REALITZACI";"70,00";"3.826,79"
"";"31/05/2021";"31/05/2021";"TRANSF DE FM UNLIMITED MOTORCYCLES,S.L. Nomina Mayo Marti Soler Chiva";"1.450,00";"3.756,79"
"";"28/05/2021";"28/05/2021";"COMPRA TARJETA DEBITO/CREDITO SUPER CHAT IGUALADA SL TJ*0011";"-9,17";"2.306,79"
"";"25/05/2021";"25/05/2021";"COMPRA TARJETA DEBITO/CREDITO S.I.M.A. TJ*0011";"-0,35";"2.315,96"
"";"25/05/2021";"25/05/2021";"COMPRA TARJETA DEBITO/CREDITO HIPERMERCAT ESCLAT H23P TJ*0011";"-15,23";"2.316,31"
"";"25/05/2021";"25/05/2021";"COMPRA TARJETA DEBITO/CREDITO FARMACIA RIGOL TJ*0011";"-23,82";"2.331,54"
"";"25/05/2021";"25/05/2021";"COMPRA TARJETA DEBITO/CREDITO FARMACIA RIGOL TJ*0011";"-50,00";"2.355,36"
"";"25/05/2021";"25/05/2021";"RECIBO PayPal (Europe) S.a.r.l. et Cie., S.C.A.";"-21,07";"2.405,36"
"";"24/05/2021";"24/05/2021";"TRANSF DE Ajuntament de Piera SERVEI RADIO AUTOMATITZACIO MODALITAT ST";"992,62";"2.426,43"
"";"21/05/2021";"21/05/2021";"COMPRA TARJETA DEBITO/CREDITO CAPRABO 7877 TJ*0011";"-4,60";"1.433,81"
"";"21/05/2021";"21/05/2021";"COMPRA TARJETA DEBITO/CREDITO S.I.M.A. TJ*0011";"-0,35";"1.438,41"
"";"21/05/2021";"21/05/2021";"COMPRA TARJETA DEBITO/CREDITO S.I.M.A. TJ*0011";"-0,70";"1.438,76"
"";"21/05/2021";"21/05/2021";"COMPRA TARJETA DEBITO/CREDITO S.I.M.A. TJ*0011";"-0,70";"1.439,46"
"";"21/05/2021";"21/05/2021";"COMPRA TARJETA DEBITO/CREDITO HIPER XINA TJ*0011";"-5,64";"1.440,16"
"";"21/05/2021";"21/05/2021";"COMPRA TARJETA DEBITO/CREDITO FARMACIA RIGOL TJ*0011";"-69,40";"1.445,80"
"";"21/05/2021";"21/05/2021";"COMPRA TARJETA DEBITO/CREDITO FARMACIA RIGOL TJ*0011";"-34,04";"1.515,20"
"";"20/05/2021";"20/05/2021";"COMPRA TARJETA DEBITO/CREDITO PIERA TJ*0011";"-57,25";"1.549,24"
"";"19/05/2021";"19/05/2021";"COMPRA TARJETA DEBITO/CREDITO HIPERMERCAT ESCLAT H23P TJ*0011";"-15,08";"1.606,49"
"";"19/05/2021";"19/05/2021";"RECIBO PayPal (Europe) S.a.r.l. et Cie., S.C.A.";"-47,32";"1.621,57"
"";"19/05/2021";"19/05/2021";"RECIBO PayPal (Europe) S.a.r.l. et Cie., S.C.A.";"-55,96";"1.668,89"
"";"19/05/2021";"19/05/2021";"RECIBO PayPal (Europe) S.a.r.l. et Cie., S.C.A.";"-63,64";"1.724,85"
"";"18/05/2021";"18/05/2021";"COMPRA TARJETA DEBITO/CREDITO S.I.M.A. TJ*0011";"-1,00";"1.788,49"
"";"14/05/2021";"14/05/2021";"COMPRA TARJETA DEBITO/CREDITO S.I.M.A. TJ*0011";"-0,75";"1.789,49"
"";"14/05/2021";"14/05/2021";"COMPRA TARJETA DEBITO/CREDITO S.I.M.A. TJ*0011";"-2,12";"1.790,24"
"";"13/05/2021";"13/05/2021";"COMPRA TARJETA DEBITO/CREDITO FARMACIA RIGOL TJ*0011";"-5,49";"1.792,36"
"";"13/05/2021";"13/05/2021";"COMPRA TARJETA DEBITO/CREDITO TALLERS PIERA SCP TJ*0011";"-650,25";"1.797,85"
"";"12/05/2021";"12/05/2021";"RECIBO SIMYO";"-10,00";"2.448,10"
"";"12/05/2021";"12/05/2021";"RECIBO SIMYO";"-11,94";"2.458,10"
"";"12/05/2021";"12/05/2021";"TRANSF DE ANNA XIVA SOLER ANNA";"137,00";"2.470,04"
"";"11/05/2021";"11/05/2021";"COMPRA TARJETA DEBITO/CREDITO JENINA FERRUS BELLES TJ*0011";"-23,00";"2.333,04"
"";"11/05/2021";"11/05/2021";"COMPRA TARJETA DEBITO/CREDITO S.I.M.A. TJ*0011";"-0,85";"2.356,04"
"";"11/05/2021";"11/05/2021";"COMPRA TARJETA DEBITO/CREDITO HIPERMERCAT ESCLAT H23P TJ*0011";"-24,11";"2.356,89"
"";"11/05/2021";"11/05/2021";"COMPRA TARJETA DEBITO/CREDITO FARMACIA RIGOL TJ*0011";"-18,40";"2.381,00"
"";"11/05/2021";"11/05/2021";"RECIBO PayPal (Europe) S.a.r.l. et Cie., S.C.A.";"-70,96";"2.399,40"
"";"10/05/2021";"10/05/2021";"COMPRA TARJETA DEBITO/CREDITO FARMACIA RIGOL TJ*0011";"-4,50";"2.470,36"
"";"10/05/2021";"10/05/2021";"COMPRA TARJETA DEBITO/CREDITO FARMACIA RIGOL TJ*0011";"-21,98";"2.474,86"
"";"10/05/2021";"07/05/2021";"COMPRA TARJETA DEBITO/CREDITO DNH*GO DADDY EUROPE EUR TJ*5783";"-69,99";"2.496,84"
"";"10/05/2021";"10/05/2021";"TRANSF DE Ajuntament de Capellades Diversos conceptes";"1.317,80";"2.566,83"
"";"08/05/2021";"08/05/2021";"COMPRA TARJETA DEBITO/CREDITO ALDI IGUALADA TJ*0011";"-24,93";"1.249,03"
"";"08/05/2021";"08/05/2021";"COMPRA TARJETA DEBITO/CREDITO SUPERMERCADOS SUPER MAS TJ*0011";"-2,81";"1.273,96"
"";"08/05/2021";"08/05/2021";"COMPRA TARJETA DEBITO/CREDITO SUPERMERCADOS SUPER MAS TJ*0011";"-39,54";"1.276,77"
"";"07/05/2021";"07/05/2021";"COMPRA TARJETA DEBITO/CREDITO S.I.M.A. TJ*0011";"-0,70";"1.316,31"
"";"07/05/2021";"07/05/2021";"COMPRA TARJETA DEBITO/CREDITO AGRO IGUALADA S C C L TJ*0011";"-24,58";"1.317,01"
"";"07/05/2021";"07/05/2021";"RECIBO COL.LEGI OFICIAL DE FARMACEUTICS DE BCN";"-37,23";"1.341,59"
"";"05/05/2021";"05/05/2021";"COMPRA TARJETA DEBITO/CREDITO S.I.M.A. TJ*0011";"-0,45";"1.378,82"
"";"05/05/2021";"05/05/2021";"COMPRA TARJETA DEBITO/CREDITO LA PANERA DEL PA IGUALADA TJ*0011";"-6,55";"1.379,27"
"";"05/05/2021";"05/05/2021";"COMPRA TARJETA DEBITO/CREDITO CAL PASSANALS TJ*0011";"-26,76";"1.385,82"
"";"05/05/2021";"05/05/2021";"RECIBO IGUANA COMUNICACIONS S.L.";"-34,00";"1.412,58"
"";"04/05/2021";"04/05/2021";"COMPRA TARJETA DEBITO/CREDITO HIPERMERCAT ESCLAT H23P TJ*0011";"-70,81";"1.446,58"
"";"03/05/2021";"03/05/2021";"RECIBO OALGT-ORPI";"-58,93";"1.517,39"
"";"03/05/2021";"03/05/2021";"RECIBO OALGT-ORPI";"-58,93";"1.576,32"
"";"30/04/2021";"30/04/2021";"COMPRA TARJETA DEBITO/CREDITO SUPERMERCADOS SUPER MAS TJ*0011";"-59,88";"1.635,25"
"";"30/04/2021";"30/04/2021";"RECIBO TGSS. COTIZACION 005 R.E.AUTONOMOS";"-1,23";"1.695,13"
"";"29/04/2021";"29/04/2021";"COMPRA TARJETA DEBITO/CREDITO HIPERMERCAT ESCLAT H23P TJ*0011";"-27,65";"1.696,36"
"";"29/04/2021";"29/04/2021";"COMPRA TARJETA DEBITO/CREDITO FARMACIA RIGOL TJ*0011";"-4,50";"1.724,01"
"";"29/04/2021";"29/04/2021";"TRANSF DE FM UNLIMITED MOTORCYCLES,S.L. Nomina Abril Marti Soler Chiva";"1.292,70";"1.728,51"
"";"28/04/2021";"28/04/2021";"TRANSF DE A.E.A.T. DEVOLUCIONES TRIBUTARIAS AEAT            APL:IVA AU";"49,57";"435,81"
"";"27/04/2021";"27/04/2021";"COMPRA TARJETA DEBITO/CREDITO PEDRAFORCA TJ*0011";"-39,95";"386,24"
"";"27/04/2021";"27/04/2021";"COMPRA TARJETA DEBITO/CREDITO CAL FONT TJ*0011";"-10,00";"426,19"
"";"26/04/2021";"26/04/2021";"COMPRA TARJETA DEBITO/CREDITO PIERA TJ*0011";"-7,72";"436,19"
"";"26/04/2021";"22/04/2021";"COMPRA TARJETA DEBITO/CREDITO MARKET IGUALAD2 TJ*0011";"-5,12";"443,91"
"";"24/04/2021";"24/04/2021";"COMPRA TARJETA DEBITO/CREDITO BEAUTY BY DIA IGUALADA 60 TJ*0011";"-7,99";"449,03"
"";"24/04/2021";"24/04/2021";"COMPRA TARJETA DEBITO/CREDITO CAL FONT TJ*0011";"-6,25";"457,02"
"";"23/04/2021";"23/04/2021";"COMPRA TARJETA DEBITO/CREDITO FARMACIA RIGOL TJ*0011";"-3,10";"463,27"
"";"23/04/2021";"23/04/2021";"COMPRA TARJETA DEBITO/CREDITO FARMACIA RIGOL TJ*0011";"-5,00";"466,37"
"";"22/04/2021";"22/04/2021";"COMPRA TARJETA DEBITO/CREDITO PIERA TJ*0011";"-13,34";"471,37"
"";"21/04/2021";"21/04/2021";"TRANSF PARA MARTA PARDOS MAS traspas";"-300,00";"484,71"
"";"21/04/2021";"21/04/2021";"COMPRA TARJETA DEBITO/CREDITO FARMACIA RIGOL TJ*0011";"-5,62";"784,71"
"";"21/04/2021";"21/04/2021";"COMPRA TARJETA DEBITO/CREDITO FARMACIA RIGOL TJ*0011";"-120,48";"790,33"
"";"21/04/2021";"21/04/2021";"TRANSF DE RADIO GELIDA MSC Automatitzacio. Factura 2021/01";"811,84";"910,81"
"";"20/04/2021";"20/04/2021";"COMPRA TARJETA DEBITO/CREDITO ABACUS IGUALADA TJ*0011";"-50,20";"98,97"
"";"20/04/2021";"20/04/2021";"COMPRA TARJETA DEBITO/CREDITO S.I.M.A. TJ*0011";"-0,65";"149,17"
"";"20/04/2021";"20/04/2021";"COMPRA TARJETA DEBITO/CREDITO S.I.M.A. TJ*0011";"-0,65";"149,82"
"";"20/04/2021";"20/04/2021";"COMPRA TARJETA DEBITO/CREDITO HIPERMERCAT ESCLAT H23P TJ*0011";"-16,42";"150,47"
"";"19/04/2021";"19/04/2021";"COMPRA TARJETA DEBITO/CREDITO S.I.M.A. TJ*0011";"-0,35";"166,89"
"";"16/04/2021";"19/04/2021";"TRANSF PARA MARTA PARDOS MAS traspas marta";"-150,00";"167,24"
"";"15/04/2021";"15/04/2021";"COMPRA TARJETA DEBITO/CREDITO S.I.M.A. TJ*0011";"-0,60";"317,24"
"";"15/04/2021";"15/04/2021";"COMPRA TARJETA DEBITO/CREDITO S.I.M.A. TJ*0011";"-2,12";"317,84"
"";"14/04/2021";"12/04/2021";"COMPRA TARJETA DEBITO/CREDITO DNH*GODADDY.COM EUROPE TJ*5783";"-61,74";"319,96"
"";"14/04/2021";"12/04/2021";"COMPRA TARJETA DEBITO/CREDITO NOMINALIA COM TJ*5783";"-58,08";"381,70"
"";"14/04/2021";"14/04/2021";"RECIBO SIMYO";"-15,57";"439,78"
"";"14/04/2021";"14/04/2021";"RECIBO SIMYO";"-10,00";"455,35"
"";"13/04/2021";"13/04/2021";"COMPRA TARJETA DEBITO/CREDITO S.I.M.A. TJ*0011";"-0,35";"465,35"
"";"13/04/2021";"13/04/2021";"COMPRA TARJETA DEBITO/CREDITO S.I.M.A. TJ*0011";"-0,35";"465,70"
"";"13/04/2021";"13/04/2021";"COMPRA TARJETA DEBITO/CREDITO HIPERMERCAT ESCLAT H23P TJ*0011";"-18,64";"466,05"
"";"13/04/2021";"10/04/2021";"COMPRA TARJETA DEBITO/CREDITO DNH*GO DADDY EUROPE EUR TJ*5783";"-18,14";"484,69"
"";"12/04/2021";"12/04/2021";"COMPRA TARJETA DEBITO/CREDITO S.I.M.A. TJ*0011";"-1,55";"502,83"
"";"12/04/2021";"12/04/2021";"RECIBO COL.LEGI OFICIAL DE FARMACEUTICS DE BCN";"-37,83";"504,38"
"";"10/04/2021";"10/04/2021";"COMPRA TARJETA DEBITO/CREDITO S.I.M.A. TJ*0011";"-0,35";"542,21"
"";"10/04/2021";"10/04/2021";"COMPRA TARJETA DEBITO/CREDITO HIPERMERCAT ESCLAT H78I TJ*0011";"-123,34";"542,56"
"";"10/04/2021";"10/04/2021";"TRANSF PARA Associaci Marta Pardos i Mas";"-42,00";"665,90"
"";"09/04/2021";"09/04/2021";"COMPRA TARJETA DEBITO/CREDITO S.I.M.A. TJ*0011";"-0,40";"707,90"
"";"09/04/2021";"09/04/2021";"COMPRA TARJETA DEBITO/CREDITO S.I.M.A. TJ*0011";"-2,12";"708,30"
"";"08/04/2021";"08/04/2021";"RECIBO IGUANA COMUNICACIONS S.L.";"-34,00";"710,42"
"";"07/04/2021";"08/04/2021";"TRANSF PARA MARTA PARDOS MAS traspas";"-500,00";"744,42"
"";"07/04/2021";"07/04/2021";"COMPRA TARJETA DEBITO/CREDITO PA IGUALADA CARRER COMES TJ*0011";"-5,65";"1.244,42"
"";"07/04/2021";"07/04/2021";"ANULACION TARJETA DEBITO";"5,65";"1.250,07"
"";"07/04/2021";"07/04/2021";"COMPRA TARJETA DEBITO/CREDITO PA IGUALADA CARRER COMES TJ*0011";"-5,65";"1.244,42"
"";"07/04/2021";"07/04/2021";"RECIBO PayPal (Europe) S.a.r.l. et Cie., S.C.A.";"-39,00";"1.250,07"
"";"04/04/2021";"04/04/2021";"COMPRA TARJETA DEBITO/CREDITO TORRES MASIP TJ*0011";"-12,05";"1.289,07"
"";"03/04/2021";"03/04/2021";"COMPRA TARJETA DEBITO/CREDITO SUPERMERCADOS SUPER MAS TJ*0011";"-84,18";"1.301,12"
"";"02/04/2021";"02/04/2021";"COMPRA TARJETA DEBITO/CREDITO CENTRE CIVIC CLARIANA TJ*5783";"-38,00";"1.385,30"
"";"01/04/2021";"01/04/2021";"COMPRA TARJETA DEBITO/CREDITO WOMEN SECRET TJ*0011";"-68,95";"1.423,30"
"";"01/04/2021";"01/04/2021";"COMPRA TARJETA DEBITO/CREDITO ASFALT TJ*0011";"-32,98";"1.492,25"
"";"31/03/2021";"31/03/2021";"COMPRA TARJETA DEBITO/CREDITO CONDIS LIFE -CAPELLADES TJ*0011";"-48,66";"1.525,23"
"";"31/03/2021";"31/03/2021";"RECIBO TGSS. COTIZACION 005 R.E.AUTONOMOS";"-2,84";"1.573,89"
"";"31/03/2021";"31/03/2021";"LIQUIDACION AHORRO/CTA COR";"0,00";"1.576,73"
"";"31/03/2021";"31/03/2021";"TRANSF DE FM UNLIMITED MOTORCYCLES,S.L. Nomina Marzo Marti Soler Chiva";"1.292,70";"1.576,73"
"";"30/03/2021";"30/03/2021";"COMPRA TARJETA DEBITO/CREDITO FRUITS SECS ROSET TJ*0011";"-14,95";"284,03"
"";"30/03/2021";"30/03/2021";"COMPRA TARJETA DEBITO/CREDITO HIPERMERCAT ESCLAT H23P TJ*0011";"-14,73";"298,98"
"";"29/03/2021";"26/03/2021";"COMPRA TARJETA DEBITO/CREDITO NOMINALIA COM TJ*5783";"-19,12";"313,71"
"";"27/03/2021";"27/03/2021";"COMPRA TARJETA DEBITO/CREDITO CASA AMETLLER SL TJ*5783";"-22,23";"332,83"
"";"27/03/2021";"27/03/2021";"COMPRA TARJETA DEBITO/CREDITO CONDIS LIFE -CAPELLADES TJ*5783";"-39,17";"355,06"
"";"27/03/2021";"27/03/2021";"COMPRA TARJETA DEBITO/CREDITO DECOR DAVID TJ*0011";"-12,26";"394,23"
"";"27/03/2021";"27/03/2021";"COMPRA TARJETA DEBITO/CREDITO CREU TJ*5783";"-7,00";"406,49"
"";"27/03/2021";"27/03/2021";"COMPRA TARJETA DEBITO/CREDITO LA PANERA DEL PA IGUALADA TJ*5783";"-9,70";"413,49"
"";"26/03/2021";"26/03/2021";"RECIBO PayPal (Europe) S.a.r.l. et Cie., S.C.A.";"-27,45";"423,19"
"";"26/03/2021";"26/03/2021";"RECIBO PayPal (Europe) S.a.r.l. et Cie., S.C.A.";"-27,32";"450,64"
"";"26/03/2021";"26/03/2021";"TRANSF DE DANIEL ORTINEZ MARTI regal";"56,00";"477,96"
"";"22/03/2021";"22/03/2021";"COMPRA TARJETA DEBITO/CREDITO S.I.M.A. TJ*0011";"-0,35";"421,96"
"";"22/03/2021";"20/03/2021";"COMPRA TARJETA DEBITO/CREDITO SHOUTCA.ST* SHOUTCA.ST TJ*5783";"-203,94";"422,31"
"";"20/03/2021";"20/03/2021";"COMPRA TARJETA DEBITO/CREDITO S.I.M.A. TJ*0011";"-0,35";"626,25"
"";"20/03/2021";"20/03/2021";"COMPRA TARJETA DEBITO/CREDITO SUPERMERCADOS SUPER MAS TJ*0011";"-84,40";"626,60"
"";"18/03/2021";"18/03/2021";"COMPRA TARJETA DEBITO/CREDITO HIPERMERCAT ESCLAT H23P TJ*0011";"-55,74";"711,00"
"";"17/03/2021";"17/03/2021";"COMPRA TARJETA DEBITO/CREDITO FARMACIA RIGOL TJ*0011";"-47,15";"766,74"
"";"16/03/2021";"16/03/2021";"COMPRA TARJETA DEBITO/CREDITO S.I.M.A. TJ*0011";"-0,75";"813,89"
"";"16/03/2021";"16/03/2021";"COMPRA TARJETA DEBITO/CREDITO HIPER ASIATO 8 TJ*0011";"-18,13";"814,64"
"";"16/03/2021";"13/03/2021";"COMPRA TARJETA DEBITO/CREDITO PAYPAL *BIKECOMPONE TJ*5783";"-186,33";"832,77"
"";"16/03/2021";"16/03/2021";"COMPRA TARJETA DEBITO/CREDITO HIPERMERCAT ESCLAT H23P TJ*0011";"-22,34";"1.019,10"
"";"16/03/2021";"16/03/2021";"COMPRA TARJETA DEBITO/CREDITO FARMACIA RIGOL TJ*0011";"-32,00";"1.041,44"
"";"15/03/2021";"15/03/2021";"COMPRA TARJETA DEBITO/CREDITO CAL FONT TJ*0011";"-17,20";"1.073,44"
"";"15/03/2021";"15/03/2021";"COMPRA TARJETA DEBITO/CREDITO S.I.M.A. TJ*0011";"-1,00";"1.090,64"
"";"13/03/2021";"13/03/2021";"COMPRA TARJETA DEBITO/CREDITO ALDI IGUALADA TJ*5783";"-8,97";"1.091,64"
"";"12/03/2021";"12/03/2021";"COMPRA TARJETA DEBITO/CREDITO PIERA TJ*0011";"-29,56";"1.100,61"
"";"11/03/2021";"11/03/2021";"COMPRA TARJETA DEBITO/CREDITO AGRO IGUALADA S C C L TJ*0011";"-43,27";"1.130,17"
"";"11/03/2021";"11/03/2021";"RECIBO PayPal (Europe) S.a.r.l. et Cie., S.C.A.";"-2,21";"1.173,44"
"";"11/03/2021";"11/03/2021";"RECIBO SIMYO";"-10,00";"1.175,65"
"";"11/03/2021";"11/03/2021";"RECIBO SIMYO";"-9,00";"1.185,65"
"";"09/03/2021";"09/03/2021";"COMPRA TARJETA DEBITO/CREDITO S.I.M.A. TJ*0011";"-0,35";"1.194,65"
"";"09/03/2021";"09/03/2021";"COMPRA TARJETA DEBITO/CREDITO HIPERMERCAT ESCLAT H23P TJ*0011";"-45,19";"1.195,00"
"";"08/03/2021";"08/03/2021";"COMPRA TARJETA DEBITO/CREDITO CAL FONT TJ*0011";"-12,08";"1.240,19"
"";"08/03/2021";"08/03/2021";"COMPRA TARJETA DEBITO/CREDITO S.I.M.A. TJ*0011";"-0,75";"1.252,27"
"";"08/03/2021";"08/03/2021";"RECIBO COL.LEGI OFICIAL DE FARMACEUTICS DE BCN";"-37,03";"1.253,02"
"";"05/03/2021";"05/03/2021";"RECIBO IGUANA COMUNICACIONS S.L.";"-14,57";"1.290,05"
"";"05/03/2021";"05/03/2021";"RECIBO ORANGE ESPAGNE S.A.";"-24,67";"1.304,62"
"";"05/03/2021";"05/03/2021";"COMPRA TARJETA DEBITO/CREDITO FARMACIA RIGOL TJ*0011";"-24,33";"1.329,29"
"";"04/03/2021";"04/03/2021";"COMPRA TARJETA DEBITO/CREDITO HIPERMERCAT ESCLAT H23P TJ*0011";"-19,14";"1.353,62"
"";"02/03/2021";"02/03/2021";"COMPRA TARJETA DEBITO/CREDITO S.I.M.A. TJ*0011";"-0,35";"1.372,76"
"";"02/03/2021";"02/03/2021";"COMPRA TARJETA DEBITO/CREDITO HIPERMERCAT ESCLAT H23P TJ*0011";"-30,89";"1.373,11"
"";"01/03/2021";"01/03/2021";"COMPRA TARJETA DEBITO/CREDITO ASFALT TJ*0011";"-34,98";"1.404,00"
"";"27/02/2021";"27/02/2021";"COMPRA TARJETA DEBITO/CREDITO S.I.M.A. TJ*0011";"-0,60";"1.438,98"
"";"27/02/2021";"27/02/2021";"COMPRA TARJETA DEBITO/CREDITO ESTACIO SERVEI ROBERT TJ*0011";"-30,00";"1.439,58"
"";"26/02/2021";"26/02/2021";"COMPRA TARJETA DEBITO/CREDITO CONDIS LIFE -CAPELLADES TJ*0011";"-8,13";"1.469,58"
"";"26/02/2021";"26/02/2021";"RECIBO TGSS. COTIZACION 005 R.E.AUTONOMOS";"-1,42";"1.477,71"
"";"26/02/2021";"26/02/2021";"RECIBO TGSS. COTIZACION 005 R.E.AUTONOMOS";"-2,84";"1.479,13"
"";"26/02/2021";"26/02/2021";"TRANSF DE FM UNLIMITED MOTORCYCLES,S.L. Nomina Febrero Marti Soler Chi";"1.292,70";"1.481,97"
"";"24/02/2021";"24/02/2021";"COMPRA TARJETA DEBITO/CREDITO CAL PASSANALS TJ*0011";"-33,80";"189,27"
"";"24/02/2021";"24/02/2021";"COMPRA TARJETA DEBITO/CREDITO ASFALT TJ*0011";"-124,96";"223,07"
"";"24/02/2021";"24/02/2021";"COMPRA TARJETA DEBITO/CREDITO S.I.M.A. TJ*0011";"-0,35";"348,03"
"";"23/02/2021";"23/02/2021";"COMPRA TARJETA DEBITO/CREDITO HIPERMERCAT ESCLAT H23P TJ*0011";"-25,11";"348,38"
"";"22/02/2021";"22/02/2021";"COMPRA TARJETA DEBITO/CREDITO FARMACIA RIGOL TJ*0011";"-6,18";"373,49"
"";"20/02/2021";"20/02/2021";"COMPRA TARJETA DEBITO/CREDITO CONDIS LIFE -CAPELLADES TJ*0011";"-16,00";"379,67"
"";"20/02/2021";"20/02/2021";"COMPRA TARJETA DEBITO/CREDITO PIERA TJ*0011";"-35,34";"395,67"
"";"20/02/2021";"20/02/2021";"COMPRA TARJETA DEBITO/CREDITO FARMACIA RIGOL TJ*0011";"-18,05";"431,01"
"";"16/02/2021";"16/02/2021";"COMPRA TARJETA DEBITO/CREDITO S.I.M.A. TJ*0011";"-0,75";"449,06"
"";"15/02/2021";"12/02/2021";"COMPRA TARJETA DEBITO/CREDITO AROMA-ZONE.COM TJ*0011";"-113,75";"449,81"
"";"15/02/2021";"12/02/2021";"COMPRA TARJETA DEBITO/CREDITO ATENEUCINEMA.CAT TJ*0011";"-9,00";"563,56"
"";"13/02/2021";"13/02/2021";"COMPRA TARJETA DEBITO/CREDITO PIERA TJ*0011";"-68,82";"572,56"
"";"11/02/2021";"11/02/2021";"COMPRA TARJETA DEBITO/CREDITO FARMACIA RIGOL TJ*0011";"-79,85";"641,38"
"";"11/02/2021";"11/02/2021";"RECIBO SIMYO";"-10,00";"721,23"
"";"11/02/2021";"11/02/2021";"RECIBO SIMYO";"-9,58";"731,23"
"";"11/02/2021";"11/02/2021";"COMPRA TARJETA DEBITO/CREDITO TALLERS PIERA SCP TJ*0011";"-157,15";"740,81"
"";"09/02/2021";"09/02/2021";"COMPRA TARJETA DEBITO/CREDITO S.I.M.A. TJ*0011";"-1,15";"897,96"
"";"09/02/2021";"09/02/2021";"RECIBO PayPal (Europe) S.a.r.l. et Cie., S.C.A.";"-92,98";"899,11"
"";"08/02/2021";"08/02/2021";"COMPRA TARJETA DEBITO/CREDITO S.I.M.A. TJ*0011";"-1,65";"992,09"
"";"06/02/2021";"06/02/2021";"COMPRA TARJETA DEBITO/CREDITO SUPERMERCADOS SUPER MAS TJ*0011";"-106,80";"993,74"
"";"05/02/2021";"05/02/2021";"RECIBO COL.LEGI OFICIAL DE FARMACEUTICS DE BCN";"-37,03";"1.100,54"
"";"05/02/2021";"05/02/2021";"RECIBO ORANGE ESPAGNE S.A.";"-29,95";"1.137,57"
"";"03/02/2021";"03/02/2021";"COMPRA TARJETA DEBITO/CREDITO S.I.M.A. TJ*0011";"-0,35";"1.167,52"
"";"03/02/2021";"03/02/2021";"COMPRA TARJETA DEBITO/CREDITO S.I.M.A. TJ*0011";"-2,12";"1.167,87"
"";"03/02/2021";"03/02/2021";"COMPRA TARJETA DEBITO/CREDITO S.I.M.A. TJ*0011";"-0,55";"1.169,99"
"";"02/02/2021";"02/02/2021";"COMPRA TARJETA DEBITO/CREDITO HIPERMERCAT ESCLAT H23P TJ*0011";"-121,48";"1.170,54"
"";"29/01/2021";"29/01/2021";"COMPRA TARJETA DEBITO/CREDITO PIERA TJ*0011";"-45,72";"1.292,02"
"";"29/01/2021";"29/01/2021";"TRANSF DE FM UNLIMITED MOTORCYCLES,S.L. Nomina Enero Marti Soler Chiva";"1.292,70";"1.337,74"
"";"25/01/2021";"25/01/2021";"COMISION TARJETA";"-24,00";"45,04"
"";"21/01/2021";"21/01/2021";"COMPRA TARJETA DEBITO/CREDITO S.I.M.A. TJ*0011";"-0,55";"69,04"
"";"19/01/2021";"19/01/2021";"COMPRA TARJETA DEBITO/CREDITO S.I.M.A. TJ*0011";"-0,35";"69,59"
"";"19/01/2021";"19/01/2021";"RECIBO COL.LEGI OFICIAL DE FARMACEUTICS DE BCN";"-37,03";"69,94"
"";"19/01/2021";"19/01/2021";"TRANSF DE MARTA PARDOS MAS TRASAS";"100,00";"106,97"
"";"15/01/2021";"15/01/2021";"COMPRA TARJETA DEBITO/CREDITO HIPERMERCAT ESCLAT H23P TJ*0011";"-20,83";"6,97"
"";"14/01/2021";"12/01/2021";"COMPRA TARJETA DEBITO/CREDITO DNH*GODADDY.COM EUROPE TJ*5783";"-579,59";"27,80"
"";"12/01/2021";"12/01/2021";"RECIBO SIMYO";"-14,00";"607,39"
"";"12/01/2021";"12/01/2021";"RECIBO SIMYO";"-10,00";"621,39"
"";"12/01/2021";"12/01/2021";"TRANSF DE MARTA PARDOS MAS TRASPSS MARTA";"200,00";"631,39"
"";"09/01/2021";"09/01/2021";"COMPRA TARJETA DEBITO/CREDITO PIERA TJ*0011";"-39,28";"431,39"
"";"08/01/2021";"08/01/2021";"RECIBO ORANGE ESPAGNE S.A.";"-29,95";"470,67"
"";"07/01/2021";"07/01/2021";"COMPRA TARJETA DEBITO/CREDITO HIPERMERCAT ESCLAT H23P TJ*0011";"-51,12";"500,62"
"";"04/01/2021";"04/01/2021";"COMPRA TARJETA DEBITO/CREDITO EL CULLEROT-IGUALADA TJ*0011";"-53,85";"551,74"
"";"04/01/2021";"04/01/2021";"COMPRA TARJETA DEBITO/CREDITO S.I.M.A. TJ*0011";"-0,35";"605,59"
"";"04/01/2021";"04/01/2021";"COMPRA TARJETA DEBITO/CREDITO SUPERMERCADOS SUPER MAS TJ*0011";"-74,93";"605,94"
"";"04/01/2021";"04/01/2021";"COMPRA TARJETA DEBITO/CREDITO ABACUS IGUALADA TJ*0011";"-74,00";"680,87"
"";"04/01/2021";"04/01/2021";"COMPRA TARJETA DEBITO/CREDITO BEAUTY BY DIA IGUALADA 60 TJ*0011";"-12,68";"754,87"
"";"04/01/2021";"04/01/2021";"COMPRA TARJETA DEBITO/CREDITO S.I.M.A. TJ*0011";"-1,45";"767,55"
"";"04/01/2021";"31/12/2020";"COMPRA TARJETA DEBITO/CREDITO DNH*GODADDY.COM EUROPE TJ*5783";"-19,14";"769,00"