"";"D. execució";"D. valor";"Concepte";"Import";"Saldo"
"";"28/02/2022";"28/02/2022";"COMPRA TARJETA DEBITO/CREDITO CREU TJ*5783";"-8,75";"2.599,18"
"";"27/02/2022";"27/02/2022";"COMPRA TARJETA DEBITO/CREDITO METRO BARCELONA TJ*5783";"-10,00";"2.607,93"
"";"27/02/2022";"27/02/2022";"COMPRA TARJETA DEBITO/CREDITO 365 TJ*5783";"-18,75";"2.617,93"
"";"25/02/2022";"25/02/2022";"COMPRA TARJETA DEBITO/CREDITO S.I.M.A. TJ*0011";"-0,35";"2.636,68"
"";"25/02/2022";"25/02/2022";"COMPRA TARJETA DEBITO/CREDITO MUY MUCHO TJ*0011";"-14,99";"2.637,03"
"";"25/02/2022";"25/02/2022";"COMPRA TARJETA DEBITO/CREDITO S.I.M.A. TJ*0011";"-1,10";"2.652,02"
"";"25/02/2022";"25/02/2022";"RECIBO MINYONS ESCOLTES GUIES SANT JORDI DE CAT";"-160,00";"2.653,12"
"";"24/02/2022";"24/02/2022";"COMPRA TARJETA DEBITO/CREDITO TALLERS PIERA 1989 S.L. TJ*0011";"-240,06";"2.813,12"
"";"24/02/2022";"24/02/2022";"RECIBO PayPal (Europe) S.a.r.l. et Cie., S.C.A.";"-60,91";"3.053,18"
"";"23/02/2022";"23/02/2022";"COMPRA TARJETA DEBITO/CREDITO MES MERCAT SL TJ*0011";"-12,35";"3.114,09"
"";"22/02/2022";"22/02/2022";"DEVOLUCION TARJETA DEBITO";"0,20";"3.126,44"
"";"22/02/2022";"22/02/2022";"COMPRA TARJETA DEBITO/CREDITO CREU TJ*0011";"-5,85";"3.126,24"
"";"22/02/2022";"22/02/2022";"COMPRA TARJETA DEBITO/CREDITO CAL PASSANALS TJ*0011";"-31,90";"3.132,09"
"";"22/02/2022";"22/02/2022";"COMPRA TARJETA DEBITO/CREDITO S.I.M.A. TJ*0011";"-0,55";"3.163,99"
"";"22/02/2022";"22/02/2022";"COMPRA TARJETA DEBITO/CREDITO HIPERMERCAT ESCLAT H23P TJ*0011";"-4,48";"3.164,54"
"";"22/02/2022";"22/02/2022";"RECIBO PayPal (Europe) S.a.r.l. et Cie., S.C.A.";"-40,00";"3.169,02"
"";"19/02/2022";"19/02/2022";"COMPRA TARJETA DEBITO/CREDITO LLIBRERIA AQUALATA SL TJ*0011";"-66,98";"3.209,02"
"";"19/02/2022";"19/02/2022";"COMPRA TARJETA DEBITO/CREDITO CAPRABO 7876 TJ*0011";"-5,72";"3.276,00"
"";"18/02/2022";"18/02/2022";"COMPRA TARJETA DEBITO/CREDITO GUISSONA T533 TJ*0011";"-5,90";"3.281,72"
"";"17/02/2022";"17/02/2022";"COMPRA TARJETA DEBITO/CREDITO EL CAFE DE L ATENEU TJ*5783";"-23,00";"3.287,62"
"";"17/02/2022";"17/02/2022";"COMPRA TARJETA DEBITO/CREDITO ESAGRISTAM S.L. TJ*0011";"-5,20";"3.310,62"
"";"17/02/2022";"17/02/2022";"COMPRA TARJETA DEBITO/CREDITO PIERA TJ*0011";"-23,75";"3.315,82"
"";"16/02/2022";"16/02/2022";"COMPRA TARJETA DEBITO/CREDITO FARMACIA RIGOL TJ*0011";"-17,95";"3.339,57"
"";"16/02/2022";"16/02/2022";"COMPRA TARJETA DEBITO/CREDITO FARMACIA RIGOL TJ*0011";"-4,00";"3.357,52"
"";"16/02/2022";"16/02/2022";"ANULACION TARJETA DEBITO";"4,00";"3.361,52"
"";"16/02/2022";"16/02/2022";"COMPRA TARJETA DEBITO/CREDITO FARMACIA RIGOL TJ*0011";"-4,00";"3.357,52"
"";"15/02/2022";"15/02/2022";"COMPRA TARJETA DEBITO/CREDITO S.I.M.A. TJ*0011";"-0,35";"3.361,52"
"";"15/02/2022";"15/02/2022";"COMPRA TARJETA DEBITO/CREDITO VITALIS TJ*0011";"-20,00";"3.361,87"
"";"15/02/2022";"15/02/2022";"COMPRA TARJETA DEBITO/CREDITO S.I.M.A. TJ*0011";"-0,35";"3.381,87"
"";"15/02/2022";"15/02/2022";"COMPRA TARJETA DEBITO/CREDITO HIPERMERCAT ESCLAT H23P TJ*0011";"-12,42";"3.382,22"
"";"14/02/2022";"14/02/2022";"COMPRA TARJETA DEBITO/CREDITO BON AREA TJ*5783";"-60,00";"3.394,64"
"";"14/02/2022";"14/02/2022";"RECIBO SIMYO";"-12,00";"3.454,64"
"";"14/02/2022";"14/02/2022";"RECIBO SIMYO";"-10,00";"3.466,64"
"";"12/02/2022";"12/02/2022";"COMPRA TARJETA DEBITO/CREDITO S.I.M.A. TJ*0011";"-1,00";"3.476,64"
"";"12/02/2022";"12/02/2022";"COMPRA TARJETA DEBITO/CREDITO SUPERMERCADOS SUPER MAS TJ*0011";"-56,97";"3.477,64"
"";"10/02/2022";"10/02/2022";"COMPRA TARJETA DEBITO/CREDITO HIPER ASIATICO 2012 S.L. TJ*0011";"-14,86";"3.534,61"
"";"09/02/2022";"09/02/2022";"COMPRA TARJETA DEBITO/CREDITO POLIGON TJ*5783";"-7,50";"3.549,47"
"";"09/02/2022";"09/02/2022";"COMPRA TARJETA DEBITO/CREDITO PIERA TJ*0011";"-26,54";"3.556,97"
"";"08/02/2022";"08/02/2022";"COMPRA TARJETA DEBITO/CREDITO S.I.M.A. TJ*0011";"-0,35";"3.583,51"
"";"08/02/2022";"08/02/2022";"COMPRA TARJETA DEBITO/CREDITO RIBA TJ*0011";"-28,53";"3.583,86"
"";"07/02/2022";"02/02/2022";"COMPRA TARJETA DEBITO/CREDITO PAYPAL *ONTHEGOSYST TJ*5783";"-43,59";"3.612,39"
"";"07/02/2022";"07/02/2022";"RECIBO IGUANA COMUNICACIONS S.L.";"-33,90";"3.655,98"
"";"05/02/2022";"05/02/2022";"COMPRA TARJETA DEBITO/CREDITO BEAUTY BY DIA IGUALADA 60 TJ*0011";"-19,17";"3.689,88"
"";"04/02/2022";"04/02/2022";"COMPRA TARJETA DEBITO/CREDITO SUPERMERCADOS SUPER MAS TJ*0011";"-57,22";"3.709,05"
"";"04/02/2022";"02/02/2022";"COMPRA TARJETA DEBITO/CREDITO PIXELGRADE ROSA2 12423 TJ*5783";"-85,00";"3.766,27"
"";"04/02/2022";"04/02/2022";"RECIBO COL.LEGI OFICIAL DE FARMACEUTICS DE BCN";"-37,23";"3.851,27"
"";"03/02/2022";"03/02/2022";"COMPRA TARJETA DEBITO/CREDITO FARMACIA RIGOL TJ*0011";"-5,25";"3.888,50"
"";"03/02/2022";"03/02/2022";"COMPRA TARJETA DEBITO/CREDITO FARMACIA RIGOL TJ*0011";"-105,99";"3.893,75"
"";"03/02/2022";"03/02/2022";"RECIBO ANA MARIA POVEDA NAVARRO";"-175,00";"3.999,74"
"";"03/02/2022";"03/02/2022";"RECIBO PIJUAN";"-38,00";"4.174,74"
"";"02/02/2022";"02/02/2022";"COMPRA TARJETA DEBITO/CREDITO CONDIS LIFE -CAPELLADES TJ*0011";"-14,81";"4.212,74"
"";"02/02/2022";"31/01/2022";"COMPRA TARJETA DEBITO/CREDITO Strato TJ*5783";"-9,02";"4.227,55"
"";"01/02/2022";"01/02/2022";"COMPRA TARJETA DEBITO/CREDITO S.I.M.A. TJ*0011";"-0,35";"4.236,57"
"";"01/02/2022";"01/02/2022";"COMPRA TARJETA DEBITO/CREDITO S.I.M.A. TJ*0011";"-1,55";"4.236,92"
"";"01/02/2022";"01/02/2022";"TRANSFERENCIA IGRID S.L. ABONO NOMINA 01/2022";"1.813,83";"4.238,47"